12 13
6 6
6 8
0 6 1 6 8 8 0 2 6 6 7 9 8
2 X X 4 X 8 6 0 6 X X 7 3
7 3 6 X 7 X 1 X 5 1 8 X 7
0 8 X 5 6 X X 9 X 1 X 6 X
2 1 0 4 2 7 X 8 3 X 5 5 1
3 4 3 7 1 5 X 0 7 9 0 4 7
2 X 5 2 2 8 6 X 9 7 6 X 3
8 8 3 1 1 7 X 2 5 X 5 2 7
1 X 6 0 7 6 2 X X 4 1 7 9
X 8 X 1 4 X X 8 5 6 8 X 9
8 7 9 X X 5 8 7 2 5 X 9 2
1 X 2 7 8 4 4 4 X 3 1 9 2